1111111111111111111111111111
100000010C00011000C000000001
10000001000001C0000000000001
10PE00000000011000C000000001
1111111111111111111111111111