1111111111111111111111111111
100000000C00000000C000000001
10000000000000C0000000000001

10PE00000000000000C000000001
1111111111111111111111111111